64 32
00 00 00 00 00 00 90 90 90 90 90 90 90 90 90 90 00 00 00 00 00 00 90 90 90 90 90 90 90 90 90 90 00 00 00 00 00 00 90 90 90 90 90 90 90 90 90 90 00 00 00 00 00 00 90 90 90 90 90 90 90 90 90 90 
00 90 90 90 90 90 90 00 00 00 00 23 00 00 00 00 00 90 90 90 90 90 90 00 00 00 00 23 00 00 00 00 00 90 90 90 90 90 90 00 00 00 00 23 00 00 00 00 00 90 90 90 90 90 90 00 00 00 00 23 00 00 00 00 
90 90 00 00 00 00 00 00 26 26 26 26 26 26 26 26 90 90 00 00 00 00 00 00 26 26 26 26 26 26 26 26 90 90 00 00 00 00 00 00 26 26 26 26 26 26 26 26 90 90 00 00 00 00 00 00 26 26 26 26 26 26 26 26 
00 90 00 00 23 00 26 26 26 00 90 90 90 00 00 00 00 90 00 00 23 00 26 26 26 00 90 90 90 00 00 00 00 90 00 00 23 00 26 26 26 00 90 90 90 00 00 00 00 90 00 00 23 00 26 26 26 00 90 90 90 00 00 00 
00 90 90 00 26 26 26 00 00 00 90 90 90 23 00 00 00 90 90 00 26 26 26 00 00 00 90 90 90 23 00 00 00 90 90 00 26 26 26 00 00 00 90 90 90 23 00 00 00 90 90 00 26 26 26 00 00 00 90 90 90 23 00 00 
00 00 90 00 26 00 23 23 00 00 90 90 90 90 23 00 00 00 90 00 26 00 23 23 00 00 90 90 90 90 23 00 00 00 90 00 26 00 23 23 00 00 90 90 90 90 23 00 00 00 90 00 26 00 23 23 00 00 90 90 90 90 23 00 
23 00 90 00 26 00 23 23 23 00 90 90 90 90 90 90 23 00 90 00 26 00 23 23 23 00 90 90 90 90 90 90 23 00 90 00 26 00 23 23 23 00 90 90 90 90 90 90 23 00 90 00 26 00 23 23 23 00 90 90 90 90 90 90 
00 00 90 00 26 23 23 23 00 00 00 00 90 90 90 90 00 00 90 00 26 23 23 23 00 00 00 00 90 90 90 90 00 00 90 00 26 23 23 23 00 00 00 00 90 90 90 90 00 00 90 00 26 23 23 23 00 00 00 00 90 90 90 90 
00 00 00 00 00 00 90 90 90 90 90 90 90 90 90 90 00 00 00 00 00 00 90 90 90 90 90 90 90 90 90 90 00 00 00 00 00 00 90 90 90 90 90 90 90 90 90 90 00 00 00 00 00 00 90 90 90 90 90 90 90 90 90 90 
00 90 90 90 90 90 90 00 00 00 00 23 00 00 00 00 00 90 90 90 90 90 90 00 00 00 00 23 00 00 00 00 00 90 90 90 90 90 90 00 00 00 00 23 00 00 00 00 00 90 90 90 90 90 90 00 00 00 00 23 00 00 00 00 
90 90 00 00 00 00 00 00 26 26 26 26 26 26 26 26 90 90 00 00 00 00 00 00 26 26 26 26 26 26 26 26 90 90 00 00 00 00 00 00 26 26 26 26 26 26 26 26 90 90 00 00 00 00 00 00 26 26 26 26 26 26 26 26 
00 90 00 00 23 00 26 26 26 00 90 90 90 00 00 00 00 90 00 00 23 00 26 26 26 00 90 90 90 00 00 00 00 90 00 00 23 00 26 26 26 00 90 90 90 00 00 00 00 90 00 00 23 00 26 26 26 00 90 90 90 00 00 00 
00 90 90 00 26 26 26 00 00 00 90 90 90 23 00 00 00 90 90 00 26 26 26 00 00 00 90 90 90 23 00 00 00 90 90 00 26 26 26 00 00 00 90 90 90 23 00 00 00 90 90 00 26 26 26 00 00 00 90 90 90 23 00 00 
00 00 90 00 26 00 23 23 00 00 90 90 90 90 23 00 00 00 90 00 26 00 23 23 00 00 90 90 90 90 23 00 00 00 90 00 26 00 23 23 00 00 90 90 90 90 23 00 00 00 90 00 26 00 23 23 00 00 90 90 90 90 23 00 
23 00 90 00 26 00 23 23 23 00 90 90 90 90 90 90 23 00 90 00 26 00 23 23 23 00 90 90 90 90 90 90 23 00 90 00 26 00 23 23 23 00 90 90 90 90 90 90 23 00 90 00 26 00 23 23 23 00 90 90 90 90 90 90 
00 00 90 00 26 23 23 23 00 00 00 00 90 90 90 90 00 00 90 00 26 23 23 23 00 00 00 00 90 90 90 90 00 00 90 00 26 23 23 23 00 00 00 00 90 90 90 90 00 00 90 00 26 23 23 23 00 00 00 00 90 90 90 90 
00 00 00 00 00 00 90 90 90 90 90 90 90 90 90 90 00 00 00 00 00 00 90 90 90 90 90 90 90 90 90 90 00 00 00 00 00 00 90 90 90 90 90 90 90 90 90 90 00 00 00 00 00 00 90 90 90 90 90 90 90 90 90 90 
00 90 90 90 90 90 90 00 00 00 00 23 00 00 00 00 00 90 90 90 90 90 90 00 00 00 00 23 00 00 00 00 00 90 90 90 90 90 90 00 00 00 00 23 00 00 00 00 00 90 90 90 90 90 90 00 00 00 00 23 00 00 00 00 
90 90 00 00 00 00 00 00 26 26 26 26 26 26 26 26 90 90 00 00 00 00 00 00 26 26 26 26 26 26 26 26 90 90 00 00 00 00 00 00 26 26 26 26 26 26 26 26 90 90 00 00 00 00 00 00 26 26 26 26 26 26 26 26 
00 90 00 00 23 00 26 26 26 00 90 90 90 00 00 00 00 90 00 00 23 00 26 26 26 00 90 90 90 00 00 00 00 90 00 00 23 00 26 26 26 00 90 90 90 00 00 00 00 90 00 00 23 00 26 26 26 00 90 90 90 00 00 00 
00 90 90 00 26 26 26 00 00 00 90 90 90 23 00 00 00 90 90 00 26 26 26 00 00 00 90 90 90 23 00 00 00 90 90 00 26 26 26 00 00 00 90 90 90 23 00 00 00 90 90 00 26 26 26 00 00 00 90 90 90 23 00 00 
00 00 90 00 26 00 23 23 00 00 90 90 90 90 23 00 00 00 90 00 26 00 23 23 00 00 90 90 90 90 23 00 00 00 90 00 26 00 23 23 00 00 90 90 90 90 23 00 00 00 90 00 26 00 23 23 00 00 90 90 90 90 23 00 
23 00 90 00 26 00 23 23 23 00 90 90 90 90 90 90 23 00 90 00 26 00 23 23 23 00 90 90 90 90 90 90 23 00 90 00 26 00 23 23 23 00 90 90 90 90 90 90 23 00 90 00 26 00 23 23 23 00 90 90 90 90 90 90 
00 00 90 00 26 23 23 23 00 00 00 00 90 90 90 90 00 00 90 00 26 23 23 23 00 00 00 00 90 90 90 90 00 00 90 00 26 23 23 23 00 00 00 00 90 90 90 90 00 00 90 00 26 23 23 23 00 00 00 00 90 90 90 90 
00 00 00 00 00 00 90 90 90 90 90 90 90 90 90 90 00 00 00 00 00 00 90 90 90 90 90 90 90 90 90 90 00 00 00 00 00 00 90 90 90 90 90 90 90 90 90 90 00 00 00 00 00 00 90 90 90 90 90 90 90 90 90 90 
00 90 90 90 90 90 90 00 00 00 00 23 00 00 00 00 00 90 90 90 90 90 90 00 00 00 00 23 00 00 00 00 00 90 90 90 90 90 90 00 00 00 00 23 00 00 00 00 00 90 90 90 90 90 90 00 00 00 00 23 00 00 00 00 
90 90 00 00 00 00 00 00 26 26 26 26 26 26 26 26 90 90 00 00 00 00 00 00 26 26 26 26 26 26 26 26 90 90 00 00 00 00 00 00 26 26 26 26 26 26 26 26 90 90 00 00 00 00 00 00 26 26 26 26 26 26 26 26 
00 90 00 00 23 00 26 26 26 00 90 90 90 00 00 00 00 90 00 00 23 00 26 26 26 00 90 90 90 00 00 00 00 90 00 00 23 00 26 26 26 00 90 90 90 00 00 00 00 90 00 00 23 00 26 26 26 00 90 90 90 00 00 00 
00 90 90 00 26 26 26 00 00 00 90 90 90 23 00 00 00 90 90 00 26 26 26 00 00 00 90 90 90 23 00 00 00 90 90 00 26 26 26 00 00 00 90 90 90 23 00 00 00 90 90 00 26 26 26 00 00 00 90 90 90 23 00 00 
00 00 90 00 26 00 23 23 00 00 90 90 90 90 23 00 00 00 90 00 26 00 23 23 00 00 90 90 90 90 23 00 00 00 90 00 26 00 23 23 00 00 90 90 90 90 23 00 00 00 90 00 26 00 23 23 00 00 90 90 90 90 23 00 
23 00 90 00 26 00 23 23 23 00 90 90 90 90 90 90 23 00 90 00 26 00 23 23 23 00 90 90 90 90 90 90 23 00 90 00 26 00 23 23 23 00 90 90 90 90 90 90 23 00 90 00 26 00 23 23 23 00 90 90 90 90 90 90 
00 00 90 00 26 23 23 23 00 00 00 00 90 90 90 90 00 00 90 00 26 23 23 23 00 00 00 00 90 90 90 90 00 00 90 00 26 23 23 23 00 00 00 00 90 90 90 90 00 00 90 00 26 23 23 23 00 00 00 00 90 90 90 90 
